                         X                 X               X
                                G      X   X             XXX
XXXXXXXXXXXXXXXX           XXXXXXXXXXXXX           XXXX     
                     XXXXXX            X                    
                        X             XXXX                  
                        X                X                 X
             XXXXXXXXXXXXXXXXXXXXXXXXX   XXXXXXXXXXXXXX    X
XXXXXXXXXXXXXX          XXXXXXXXXXXXXX                     X
                        XXXXXXXXXXXXXX                     X
XX                      X         X                         
                        X                                   
                        X         X                         
S                                 X                         