XXXXXXXXXXXXXXXXXXXXXXXXXXXXXXXXXXXXXXXXXXXX
XXXXXXXXX                    XXXXXXXXXXXXXXX
XXXXXXXXX                    XXXXXXXXXXXXXXX
XXXXXXXXX  XXXXXXXXXXXXXXXX  XXXXXXXXXXXXXXX
XXXXXXXXX  XXXXXXXXXXXXXXXX  XXXXXXXXXXXXXXX
XXXXXXXXX  XXX        XXXXX  XXXXXXXXXXXXXXX
XXXXXXXXX  XXX  XXXXX XXX    XXXXXXXXXXXXXXX
XXXXXXXXX  XXX  XX  S XXXG   XXXXXXXXXXXXXXX
XXXXXXXXX  XXX  XXXX XXXXXXXXXXXXXXXXXXXXXXX
XXXXXXXXX  XXX  XXXX XXXX XXXXXXXXXXXXXXXXXX
XXXXXXXXX  XXX  XXXX XXXX XXXXXXXXXXXXXXXXXX
XXXXXXXXX       XXXX XXXX XXXXXXXXXXXXXXXXXX
XXXXXXXXX       XXXX      XXXXXXXXXXXXXXXXXX
XXXXXXXXXXXXXXXXXXXXXXXXXXXXXXXXXXXXXXXXXXXX