XXXXXXXXXXXXXXXXXXXXXXXXXXXXXXXXXXXXXXXXX
X   X       X     X           X         X
X X X XXX X X XXX X XXXXXXX XXX XXXXXXX X
X XSX   X X   X   X X     X           X X
X XXXXX X XXXXXXXXX X X XXXXXXXXXXXXX X X
X X     X X         X X       X   X   X X
X X XXXXX X XXXXXXXXX XXXXX X X X X XXX X
X X     X   X     X     X   X X X X X X X
X XXXXX XXXXXXXXX X XXXXX XXX X X X X X X
X   X           X   X     X   X X X   X X
X XXX XXXXXXXXX X XXX XXXXX XXX X XXXXX X
X   X   X     X X X   X       X X       X
X X XXX X XXX X XXX XXX XXXXXXX XXXXXXX X
X X     X X   X     X   X X     X     X X
X XXXXXXX X XXXXXXXXXXX X X XXXXX X XXX X
X     X X X   X       X   X X   X X     X
XXXXX X XXXXX X XXXXX XXX X XXX X XXXXXXX
X   X X     X X   X   X   X X   X     X X
X XXX XXX XXX XXX X XXX XXX X XXXXXXX X X
X   X     X   X   X X   X   X X     X   X
XXX XXXXX X XXX XXX XXX X XXX X XXX XXX X
X       X X   X X X   X X X   X X X     X
X XXXXXXX XXX X X XXX XXX X XXX X XXXXXXX
X       X   X   X   X X   X     X       X
X XXXXX XXX XXXXX X X X XXXXX XXX XXX XXX
X   X X X   X     X X X     X X     X   X
XXX X X X XXX X XXXXX X XXX X X XXXXXXX X
X X   X   X   X X     X   X X X X     X X
X XXX XXXXX XXX X XXXXX XXX X X X XXX X X
X   X       X   X X X   X   X X X   X   X
X X XXXXXXXXX XXX X X XXX XXX X XXX XXXXX
X X     X   X X X X   X   X X X   X     X
X XXXXX X X X X X XXX X XXX X XXXXXXXXX X
X X   X X X X X X   X X   X             X
X X X X X X X X XXX XXX X XXXXXXXXXXXXX X
X X X     X X X   X   X X       X       X
X XXXXXXXXX X X X XXX XXX XXXXX X XXXXXXX
X     X     X X X   X   X X     X X     X
X XXX XXXXXXX XXX X XXX XXX XXXXX X XXX X
X   X             X   X     X       XG  X
XXXXXXXXXXXXXXXXXXXXXXXXXXXXXXXXXXXXXXXXX